Grapheme	IPA
a	a
c	c
ch	tʃ
h	h
i	ɨ
í	ɨ
b	b
j	x
m	m
n	n
o	o
p	p
qu	k
r	ɾ
sh	ʃ
s	s
z	z
t	t
tz	ts
u	ɯ
ú	ɯ
e	e
v	v
x	χ
y	j
á	a
ó	o
^-	NULL
-$	NULL
-	+
