Grapheme	IPA
b	b
č	tʃ
c̷	ts
š	ʃ
tʸ	tʲ
e	e
é	é/e
w	w
r	r
y	j
k	k
h	h
kʷ	kʷ
d	d
lʸ	lʲ
dʸ	dʲ
ʔ	ʔ
i	i
m	m
n	n	
ɲ	ɲ
o	o
p	p
s	s
t	t
í	í/i
a	a
á	á/a
ai	ai
^-	NULL
-$	NULL
-	+
