Grapheme	IPA	Note
č	tʃ
š	ʃ
c̷	ts
w	w
a	a
e	e
i	i
r	r
β	β
k	k
ɨ	ɨ
ʔ	ʔ
h	h
m	m
n	n
o	o
p	p
ɾ	ɾ
t	t
s	s
ṣ̌	ʂ
y	j
z	z
kʷ	kʷ
l	l
ɲ	ɲ
ǰ	dʒ
'	NULL
^-	NULL
-$	NULL
-	+
