Grapheme	IPA
p	p
t	t
d	d
k	k
kw	kʷ
b	b
s	s
š	ʃ
ts	ts
č	tʃ
h	h
m	m
n	n
w	w
y	j
a	a
e	e
i	i
õ	õ
ã	ã
ĩ	ĩ
o	o
ʔ	ʔ
'	NULL
x	x
ɲ	ɲ
^e-	NULL
-xi	NULL
-xe	NULL
-kwe	NULL
^-	NULL
-$	NULL
-	+
