Grapheme	IPA
a	a
b	b
d	d
e	ɛ
ë	ɨ
ʈʂ	tʂ
ʂ	ʂ
ch	tʃ
sh	ʃ
ts	ts
i	i
m	m
n	n
o	o
p	p
qu	k
c	k
u	u
s	s
t	t
u	u
y	j
w	w
iai	j e
uai	w e
aie	a j
ioe	j e
ai	e
-	+
