Grapheme	IPA
p	p
t	t
d	d
qu	k
c	k
k	k
cu	kʷ
b	b
v	v
s	s
tch	tʃ
ç	tʃ
l	l
r	r
f	f
ch	ʃ
zç	ts
z	ʂ
m	m
n	n
gu	gʷ
g	g
h	h
x	x
a	a
á	a
é	e
e	e
ẽ	e
ú	u
i	i
ô	õ
o	o
ó	o
u	u
ai	ai
ia	j a
io	j o
iu	j u
aui	a w i
ui	ui
au	au
-	+
