Grapheme	IPA	Note
a	a
o	o
i	i
u	u
e	e
p	p
t	t
k	k
kʷ	kʷ
ʔ	ʔ
b	b
ɓ	ɓ
d	d
ɗ	ɗ
β	β
s	s
č	tʃ
h	h
ɬ	ɬ
m	m
n	n
n̉	pʔⁿ
m̉	tʔⁿ
l	l
r	r
w	w
y	j
au	au
ai	ai
^-	NULL
-$	NULL
-	+
