Grapheme	IPA
p	p
t	t
k	k
b	b
s	s
š	ʃ
ṣ̌	ʂ
ts	ts
h	h
m	m
n	n
r	r
w	w
y	j
a	a
e	e
ɨ̃	ɨ̃
ɨ	ɨ
õ	õ
ã	ã
ĩ	ĩ
β	β
i	i
o	o
c̷	ts
č	tʃ
^-	NULL
-$	NULL
-	+
