Grapheme	IPA	Note
i	i
ĩ	ĩ
e	e
ẽ	e
æ	ə
œ	ɨ
œ̃	ɨ̃
a	a
á	a
ã	ã
o	o
õ	õ
u	u	alternation of /o/
ũ	ũ
y	j
dg	dʲ
fer'gič	f e r
w	w
ph	pʰ
p	p
t	t
dʸ	dʲ
tʸ	tʲ
d	d
kh	kʰ
k	k
b	b
ʔ	ʔ
h	h
f	f
v	ʋ
s	s
c̷	ts
c̷h	tsʰ
č	tʃ
tč	tʃ	probably an error in annotation, or aspirated
š	ʃ
r	r
m	m
n	n
x	x	phoneme together with /h/
ñ	ɲ
ɲ	ɲ
'	NULL
^-	NULL
-$	NULL
-	+
